111111111111111
10C010C010C01E1
101010101010101
1P10C010C010C01
111111111111111