111111111111111111
1LLL10000000000001
11111000001CCC1001
1C0000000116661101
11000000116EEE6C01
1P000000000EEE6C01
11000000116EEE6C01
1C0000000116661101
11111000001CCC1001
1LLL10000000000001
111111111111111111