1111111111111111111111111111111
1P1C00000011C000000000000000001
101110000111LLLLLLLLLL000000001
10110000LLLLLLLLLLLLLLLL0000001
1000C000LLLLLLLLLLLLLLLLL000001
110000000LLLLLLLLLLLLLL00000111
111100000000C0LLLLLL00000001111
11C20000000022200000000000220E1
1111111111111111111111111111111