1111111111111111111111111111111111
1E0000LLL0000000000000000000011111
1LL0111110000000011111110000000011
1L11111100000000000111110000LLL221
1LL00000000000000000000000LLLLL221
1000LL0000000000O0000000000LLLLL21
1000111100C0000000000000000000LLC1
1011111111000000000000011000000011
1000000111111100000000111100000011
1LLL000000111111111000000000000111
1LLLLLL00000000111C0000LLLL0001111
1LLLLLLLLC00LLLL11100LLLLLLLL000P1
1111111111111111111111111111111111