1111111111111111111111111111111111111111
1E22000000000000000022C22200000011111C11
1111100000000000000002222200000001111211
1011110000020000000100000000000000122211
1000110112222000011100000001100000022111
10000001111020000110000O0001110000001111
10000000110000000000000000001100000001P1
1000000000000000000000000000000011110001
1000000000000000000000000000000111111121
1000012200000000000000000111111111000001
10001122220000000111111111111C2220000001
100000C122000111111111111111111120000001
1111111111111111111111111111111111111111