1111111111111111111111111111111111111111
1P2211C000001112221100000000000110000011
12221111100001101C110000000001110011C111
1122021111110010111000000000001100211101
1111120021100000000011111000000000222201
11C1100C000000000C01110C11000000112110E1
1100000000000000000002211111001111011111
1111000000111111000000000000011122001111
1110001111111111111000000000000222000011
1C00100222200C11111111C000000002110000C1
1111111111111111111111111111111111111111