111111111111111111111111111111111111111
1110LL0000000000000P00000000LLLLLLLLLL1
11C0LLL0000000000000000000000LLLLLLLLL1
1110LL0000000001C00000C10000000000LLLL1
11111110000000011100011100000000000LLL1
11111000000000000000000000000000LLLLL01
10C11100001110000000000000000LLLLLL0001
12221111000000000000O00000011111111C001
122222220000000000000000000001111111101
122221111110000000000000000000000000001
122211110000000000000000000000000000001
122000000000LL000000000000000LLLLLL0001
1000000000LLLLLL0000000000LLLLLLLLL0001
100011000000LLLL001010000000000LLLLL001
100C011000000000011E1100000000000000001
111111111111111111111111111111111111111