11111111111111111111111111111
10C1000000000000000C1100000P1
100111000001000000011000001C1
1100100000C110000011110000111
11100000111111100000000000011
10001111111111111111111100111
110000000000011111C1100111111
1101100C1110000000000000000E1
11111111111111111111111111111