111111111111111111111111111111111111111
100000000000000000000000000000000000001
100000000000000000000000000001010000001
1C10000001000000000000000000110C0000001
11100000011001000010000C000000010000001
1P0000000C10000000C000O100000000000C0E1
11100000011001000010000C000000010000001
1C10000001000000000000000000110C0000001
100000000000000000000000000001010000001
100000000000000000000000000000000000001
111111111111111111111111111111111111111