11111111111111111111111111111
100110000C1000000001000001101
10C11100O110000000000000110P1
10001000010000001100000000001
10000011000C00000101100000001
11010010000111000000111000001
1E0110C0000011000000110C00001
11111111111111111111111111111